NO ./src/textures/huge_1.png
SO ./src/textures/huge_2.png
EA ./src/textures/huge_3.png
WE ./src/textures/huge_4.png

C 60,150,0
F 60,100,100








        111111111111111111111111111111111
        10010000001100000000000#000000001
        100d0000011100000000000#000000001
        10010000000000000000000#000000001
1111111100010000000000000000000#000000001
1#000000000100000111000000000111110110011
110000000001000001000000000000001111111
1111111d1111001001110000000001111111
1111000000000100010100000000010010001
1100000000000101110000000000000010001
10#00#000#000#00#00000000000000010001
100000000000000011N100000000010000001
110000#1110101011111000000000111100011
11110111 1110101 10111111111111010001
11111111 1111111 11111111111111111111
