NO ./path_to_the_north_texture
SO ./path_to_the_south_texture55
WE ./path_to_the_west_texture 

F 220,100,0
EA ./path_to_the_east_texture
C 225,30,0








        1111111111111111111111111
        1000000000110000000000001
        1011000001110000000000001
        1001000000000000000000001
111111111011000001110000000000001
100000000011000001110111110110011
1100000011111101110000001111111
1111111d11111111111101111111
11110000111111011101010010001
11000000110101011100000010001
1S000000000000000000000010001
10000000000000001101010000001
110000011101010111110111100011
11110111 1110101 101111010001
11111111 1111111 111111111111
