SO ./src/textures/huge_2.png
NO ./src/textures/huge_1.png
EA       ./src/textures/cool1.png
WE ./src/textures/huge_4.png
C 10,60,80
F 0,0,0




        11111111111111111111111111111111
        10010000001100000000#0d0000000001
        100d00000111000000000000000000001
        10010000000000#0000000000000#0001
11111111000100000000000000000000000000001
1#000000000100000111000000000111110110011
1100000000010000010000000#0000001111111
1111111d1111001001110000000001111111
11110000000001000101dddddddd10010001
1100000000000101110000000000000010001
10#00#000#00#000#0000000000000010001
100000000000000011N100000#00010000001
110000#1110101011111000000000111100011
11110111 1110101 10111111111111010001
11111111 1111111 11111111111111111111
