NO ./textures/huge_1.png
EA ./textures/huge_2.png
SO ./textures/wall.png
WE ./textures/huge_4.png

C 20,90,120
F 50,190,0

1111111111111111111111111
1000000000110000000000001
1011000001110000000000001
100100000000000000000000111111111
111111111011000001110000000000001
100000000011000001110111111111111
11110111111111011100000010001
11110111111111011101010010001
1100000011010101110000100#001
100000000000000011000#100001
10000000000000001101011###001
1100000111010101111101d000N0011
11110111 1110101 101111000001
11111111 1111111 111111111111