C 10,60,80
NO ./textures/huge_1.png




EA ./textures/huge_2.png
SO ./textures/wall.png
WE ./textures/huge_4.png
F 125,0,125

        111111111111111111111111111111111
        10010000000100000000#000000000001
        100d00000001000000000000000000001
        10010000000100#0000000000000#0001
11111111000100#0000d000000000000000000001
1#000000000100000001000000000111000110011
1000000000010000000100000#0000000001111
1000111d1111111111110000000000111001
1111000000000000000000000000000010001
10000000000000000000000#0000000010001
10#00#000#000#00#00000000000000010001
100000000000000000N000000#00000000001
100000#1110000011110000000000000000011
11000001  100001 10111111111111000001
11111111  111111 111          1111111
